█████████████████████████████████████████
█ 🐹            █                       █
█████████████   █████████   █████████   █
█           █           █       █   █   █
█   █   █   █████████   █████   █   █   █
█   █   █       █       █       █       █
█   █   █████   █   █████   █████   █████
█   █   █ 🔥█   █         🔥█ 🔥█ 🔥█   █
█   █   █████   █████████████████████   █
█   █   █ 🔥█   █                 🔥█   █
█   █   █████████   █████████   █████   █
█   █     🔥█ 🔥█ 🔥█     🔥█ 🔥█ 🔥█   █
█   █████████████████   █████████████   █
█   █       █   █ 🔥█   █ 🔥█   █       █
█   █   █   █   █████   █████   █████████
█   █   █   █   █ 🔥█   █ 🔥█ 🔥█ 🔥█   █
█   █████   █   █████   █████████████   █
█       █   █   █       █       █       █
█████   █   █   █████████   █████   █   █
█           █                       █ 🚪█
█████████████████████████████████████████
