█████████████████████████████████
█ 🐹            █               █
█████████████   █   █████   █████
█       █       █       █       █
█████   █   █████████   █████   █
█     🔥█   █         🔥█ 🔥█ 🔥█
█   █████   █████████████████████
█   █ 🔥█   █               █ 🔥█
█   █████████   █████████   █████
█   █ 🔥█ 🔥█ 🔥█     🔥█ 🔥█ 🔥█
█   █████████████   █████████████
█   █         🔥█     🔥█   █   █
█   █   █   █████████████   █   █
█   █   █     🔥█     🔥█ 🔥█ 🔥█
█   █   █████████   █████████████
█               █             🚪█
█████████████████████████████████
